7
16
0045002006000006
0045000006000006
0045009006002006
0045000006000006
0045000206446446
0045000006000006
0045000006002006